XXXXXXXXXXXXXXXXXXXX
X                  X
X G               BX
XXXX            XXXX
X                  X
X                  X
X      XXXXX       X
X                  X
X                  X
XXXXXXXXXXXXXXXXXXXX