
X                X
XG              BX
XXX            XXX
XCCCCCCCCCCCCCCCCX
XCCCCCCCCCCCCCCCCX
XCCCCCCCCCCCCCCCCX
XCCCCCCCCCCCCCCCCX
XCCCCCCCCCCCCCCCCX
XXXXXXXXXXXXXXXXXX             